1,0
Player,0,0,100
Computer,1,1,100
#
p,p,p,f,f,p,p,p,p,p,p,v,p,p,p,p
p,p,v,f,p,f,p,p,p,p,p,p,p,p,p,p
p,c,p,p,p,p,p,p,p,p,p,p,p,f,p,p
p,m,m,p,p,p,p,p,p,f,p,p,f,p,p,p
p,p,p,p,p,m,p,p,p,f,f,p,f,m,p,p
p,p,p,v,m,m,m,p,p,p,f,p,m,c,p,p
p,p,p,p,p,p,p,p,p,p,p,p,p,p,p,p
#
0,0,1,1,0,3,1
1,0,2,5
#
1,2,1
2,5,13
#