1,0
mie,0,0,100
vihu,0,1,100
#
p,p,p,p,p,f,f,f,p,f,f,f,p
p,m,m,p,p,p,p,p,p,f,f,f,p
p,m,p,p,p,p,m,p,p,p,p,p,p
p,p,p,p,p,p,m,p,p,p,p,m,p
p,f,f,f,p,p,p,p,p,p,m,m,p
p,f,f,f,p,f,f,f,p,p,p,p,p
#
0,0,1,1,0,3,1
1,1,2,5
#