1,0
Player,0,0,100
Computer,1,1,100
#
p,p,p,p,p,p,p,p,p,p,p,v,p,m,m,m
p,p,v,p,p,f,p,f,m,m,p,p,p,p,m,p
p,c,p,p,p,p,p,f,m,m,p,p,p,f,p,p
p,m,m,p,p,p,p,p,m,m,p,p,f,p,p,p
p,p,p,p,p,m,p,v,m,m,f,p,f,m,p,p
p,p,p,v,m,m,m,p,p,v,f,p,m,c,p,p
p,p,p,p,m,m,m,p,p,p,p,p,p,p,p,p
#
0,2,2,1
1,2,5,13
#
1,2,1
2,5,13
#